111111111111111111111111111111111
10000000000000000000000000C000001
10000000000000000000000000000E001
10000000111000000111000000C000001
100000010010000010001000000000001
10000010001000010000010000C000001
100001000010000000000100000000001
10001111111000000000100000C000001
100000000010000000010000000000001
10000000001000000010000000C000001
100000000010000011111100000000001
10C0C0C0C0C0C0C0C0C0C0C0C0C000001
10P000000000000000000000000000001
111111111111111111111111111111111
