11111111
10000001
11111101
1E0000P1
11111111
