1111111111111111111111111111
1CCCCCCCCCCCC1CCCCCCCCCCCCC1
1C1111C11111C1C11111C11111C1
1C1111C11111C1C11111C11111C1
1CCCCCCCCCCCCCCCCCCCCCCCCCC1
1C1111C1C111111111C1C11111C1
1CCCCCC1CCCCC1CCCCC1CCCCCCC1
111111C1111101011111C1111111
111111C1000000000001C1111111
111111C101111E111101C1111111
100000C0011111111100C0000001
111111C1000000000001C1111111
111111C1011111111101C1111111
1CCCCCCCCCCC1CCCCCCCCCCCCCC1
1C11111C11111C1C11111C1111C1
1CCCCC1CCCCCCCPCCCCCCC1CCCC1
1CCCCC1C1C111111111C1C1CCCC1
1CCCCCCC1CCCCC1CCCCC1CCCCCC1
1C11111111111C1C1111111111C1
1CCCCCCCCCCCCCCCCCCCCCCCCCC1
1111111111111111111111111111
