111111111111111
100001C0000C1E1
100111000001001
1C0000P11111011
1000011111110C1
100000000000001
111111111111111
