111111111111111
1C0000000000001
100E00000000001
10000C000000P01
111111111111111
